╔════════════╦┬════════════╗
║············│|············¦
║·┌────────┐·│|·┌────────┐·¦
║·│  ┌-----┘·│|·│  ┌---┐ |·¦
║·│  |·······└┘·│  |···└-┘·¦
║·│  └─────┐····│  |·······¦
║·│  ┌-----┘····│  |···┌─┐·¦
║·│  |··········│  └───┘ |·¦
║·└--┘··········└--------┘·¦
║··························¦
╚====╗·┌┐··········┌┐·╔====╝
     ║·│|,,,,,,,,,,│|·¦     
     ║·│|,╔══════╗,│|·¦     
═════╝·└┘,║      ¦,└┘·╚═════
,,,,,,·,,,║      ¦,,,·,,,,,,
=====╗·┌┐,║      ¦,┌┐·╔=====
     ║·│|,╚======╝,│|·¦     
     ║·│|,,,,,,,,,,│|·¦     
     ║·│|,┌──────┐,│|·¦     
╔════╝·└┘,└------┘,└┘·╚════╗
║··························¦
║·┌──────────┐··┌────────┐·¦
║·└---┐  ┌---┘··│  ┌---┐ |·¦
║·····│  |······│  |···└-┘·¦
║·····│  |······│  |·······¦
║·····│  |······│  |·······¦
║·····│  |······│  |···┌─┐·¦
║·····│  |······│  └───┘ |·¦
║·····└--┘······└--------┘·¦
║··························¦
╚==========================╝
