╔══════════════════════════╗
║··························¦
║·┌──────────────┐·┌─────┐·¦
║·│  ┌-----------┘·└-----┘·¦
║·│  |·····················¦
║·│  └───┐·┌─────────────┐·¦
║·│  ┌---┘·└-----┐   ┌---┘·¦
║·│  |···········└┐  |·····¦
║·└--┘·┌┐·┌─────┐·│  |·····¦
║······│|·│ ┌-┐ |·│ ┌┘·····¦
╚====╗·│|·└-┘·└-┘·└┐|·╔====╝
     ║·│|,,,,,,,,,,│|·¦     
     ║·│|,╔══════╗,│|·¦     
═════╝·└┘,║      ¦,└┘·╚═════
,,,,,,·,,,║      ¦,,,·,,,,,,
=====╗·┌┐,║      ¦,┌┐·╔=====
     ║·│|,╚======╝,│|·¦     
     ║·│|,,,,,,,,,,│|·¦     
     ║·│|,┌──────┐,│|·¦     
╔════╝·└┘,└------┘,└┘·╚════╗
║··························¦
║·┌──────────┐·┌─────────┐·¦
║·│  ┌-------┘·└-------┐ ¦·¦
║·│  |··········┌┐·····| ¦·¦
║·│  |·┌──┐·┌─┐·│|·┌┐··└-┘·¦
║·│  |·└--┘·└-┘·└┘·│|······¦
║·│  |·············└┘··┌─┐·¦
║·│  └────────┐·┌──────┘ |·¦
║·└-----------┘·└--------┘·¦
║··························¦
╚==========================╝
