╔════════════╦┬════════════╗
║············│|············¦
║·┌────────┐·│|·┌────────┐·¦
║·│  ┌-----┘·│|·│ ┌----┐ |·¦
║·│  |·······└┘·│ |·┌┐·└-┘·¦
║·│  └─────┐·┌┐·│ |·└┘·····¦
║·│  ┌-----┘·│|·│ |····┌─┐·¦
║·│  |·······│|·│ └────┘ |·¦
║·└--┘·┌┐·┌┐·│|·└--------┘·¦
║······│|·│|·│|············¦
╚====╗·│|·└┘·└┘····┌┐·╔====╝
     ║·│|,,,,,,,,,,│|·¦     
     ║·│|,╔══════╗,│|·¦     
═════╝·└┘,║      ¦,└┘·╚═════
,,,,,,·,,,║      ¦,,,·,,,,,,
=====╗·┌┐,║      ¦,┌┐·╔=====
     ║·│|,╚======╝,│|·¦     
     ║·│|,,,,,,,,,,│|·¦     
     ║·│|,┌──────┐,│|·¦     
╔════╝·└┘,└------┘,└┘·╚════╗
║··························¦
║·┌──────────┐··┌────────┐·¦
║·└---┐  ┌---┘··│ ┌----┐ |·¦
║·····│  |······│ |····└-┘·¦
║·┌─┐·│  |·┌──┐·│ |·┌┐·····¦
║·└-┘·│  |·└--┘·│ |·└┘·····¦
║·····│  |······│ |····┌─┐·¦
║·┌─┐·│  |·┌──┐·│ └────┘ |·¦
║·└-┘·└--┘·└--┘·└--------┘·¦
║··························¦
╚==========================╝
