╔════════════╦┬════════════╗
║············│|············¦
║·┌────────┐·│|·┌────────┐·¦
║·│┌-------┘·│|·└-------┐|·¦
║·└┘·········└┘·········└┘·¦
║······┌───┐····┌───┐······¦
║·┌──┐·└--┐└────┘┌--┘·┌──┐·¦
║·└--┘····└------┘····└--┘·¦
║······┌┐··········┌┐······¦
╚====╗·│└──┐,┌┐,┌──┘|·╔====╝
     ║·│┌--┘,└┘,└--┐|·¦     
     ║·│|,,,,,,,,,,│|·¦     
     ║·│|,╔══════╗,│|·¦     
═════╝·└┘,║      ¦,└┘·╚═════
,,,,,,·,,,║      ¦,,,·,,,,,,
=====╗·┌┐,║      ¦,┌┐·╔=====
     ║·│|,╚======╝,│|·¦     
     ║·│|,,,,,,,,,,│|·¦     
     ║·│|,┌──────┐,│|·¦     
╔════╝·└┘,└--┐┌--┘,└┘·╚════╗
║············└┘············¦
║·┌──┐·┌───┐·┌┐·┌───┐·┌──┐·¦
║·└-┐|·└---┘·└┘·└---┘·│┌-┘·¦
║···└┘················└┘···¦
╠─┐····┌┐·┌──────┐·┌┐····┌─╣
║ |····│|·└--┐┌--┘·│|····│ ¦
║ |····│|····│|····│|····│ ¦
├-┘··┌─┘└──┐·│|·┌──┘└─┐··└-┤
║····└-----┘·└┘·└-----┘····¦
║··························¦
╚==========================╝
