╔════════════╦┬════════════╗
║············│|············¦
║·┌──┐·┌───┐·│|·┌───┐·┌──┐·¦
║·│  |·│   |·│|·│   |·│  |·¦
║·└--┘·└---┘·└┘·└---┘·└--┘·¦
║··························¦
║·┌──┐·┌┐·┌──────┐·┌┐·┌──┐·¦
║·└--┘·│|·└--┐┌--┘·│|·└--┘·¦
║······│|····│|····│|······¦
╚====╗·│└──┐,│|,┌──┘|·╔====╝
     ║·│┌--┘,└┘,└--┐|·¦     
     ║·│|,,,,,,,,,,│|·¦     
     ║·│|,╔══════╗,│|·¦     
═════╝·└┘,║      ¦,└┘·╚═════
,,,,,,·,,,║      ¦,,,·,,,,,,
=====╗·┌┐,║      ¦,┌┐·╔=====
     ║·│|,╚======╝,│|·¦     
     ║·│|,,,,,,,,,,│|·¦     
     ║·│|,┌──────┐,│|·¦     
╔════╝·└┘,└--┐┌--┘,└┘·╚════╗
║············│|············¦
║·┌──┐·┌───┐·│|·┌───┐·┌──┐·¦
║·└-┐|·└---┘·└┘·└---┘·│┌-┘·¦
║···│|················│|···¦
╠─┐·│|·┌┐·┌──────┐·┌┐·│|·┌─╣
├-┘·└┘·│|·└--┐┌--┘·│|·└┘·└-┤
║······│|····│|····│|······¦
║·┌────┘└──┐·│|·┌──┘└────┐·¦
║·└--------┘·└┘·└--------┘·¦
║··························¦
╚==========================╝

